%%%%%%%%%
%R      %
%  %%%%% 
%  %   % 
%  % T % 
%  %   % 
%  %M  % 
%  %S  % 
%  %%%%% 
%       %
%%%%%%%%%